NO ./texture/bluelined_tile.xpm
SO ./texture/bookshelf.xpm
WE ./texture/hex_tile.xpm
EA ./texture/rect_tile.xpm

F ./texture/hex_tile.xpm
C ./texture/hex_tile.xpm

        11111111111   1111111111111111
        100000000011111110000000000001
        1011000000000000000000N0000001
        100100000011111000000000000001
1111111110110000011   1110000000000001
1000000000110000011   1110111100011111
1111011111111101111   100000010001
1111011111111101111   101010010001
1100000011010101111   100000010001
1000111000000000111   100000010001
1000101000000000111   101010010001
1100111111010101111   1110111100111
11110111 1110101 11   101111010001
11111111 1111111 11   1111111111111